rows 102
cols 114
players 2
m ......%%................%%%................%%............................%%................%%%................%%..
m ......%%%................%%...............%%%............................%%%...............%%................%%%..
m .%%....%%...%%%.%...%....%....%%%...%%%...%%....%....%.%%....%%.%....%....%%...%%%...%%%....%....%...%.%%%...%%...
m .%%...%%....%%%%%%%%.....%.....%%...%%%%%%%%%....%%%%%%%......%%%%%%%....%%%%%%%%%...%%.....%.....%%%%%%%%....%%..
m .%%...%%%....%..%%%%%...%.%....%.....%%%.%.%%...%%%%%..%%....%%..%%%%%...%%.%.%%%.....%....%.%...%%%%%..%....%%%..
m .......%..........%%..........%%%...%%..........%%..................%%..........%%...%%%..........%%..........%...
m .......%...........%%..........%%....%..........%%..................%%..........%....%%..........%%...........%...
m .......%..........%%..........%%%....%%.........%%%................%%%.........%%....%%%..........%%..........%...
m %%%%%.%%%%%.%%.....%%...%.....%%....%%%...%.%%.%%%....%.%....%.%....%%%.%%.%...%%%....%%.....%...%%.....%%.%%%%%.%
m %%%%%%%%%%%%%%....%%%%%%%%%%%%%%.....%.....%%%%%%%%...%%%....%%%...%%%%%%%%.....%.....%%%%%%%%%%%%%%....%%%%%%%%%%
m %%%%.%.%%...%%%...%%%%%%%%%%%%%.%...%%%...%%%%.%%%%....%%....%%....%%%%.%%%%...%%%...%.%%%%%%%%%%%%%...%%%...%%.%.
m .%%..........%...........%..........%%%....%.....%..................%.....%....%%%..........%...........%.........
m .%%..........%%.........%%..........%%....%%%...%%..................%%...%%%....%%..........%%.........%%.........
m .%%.........%%..........%%..........%%....%%%....%%................%%....%%%....%%..........%%..........%%........
m .%%.....%....%%%...%%.0..%%...%...%.%%%...%%.....%%...%.%....%.%...%%.....%%...%%%.%...%...%%..1.%%...%%%....%....
m .......%.....%%%%%%%.....%%%%%%%%%%%%%%...%%....%%.....%%%%%%%%.....%%....%%...%%%%%%%%%%%%%%.....%%%%%%%.....%...
m .%%....%%...%%%....%%....%%.%%%%.%.%.......%%...%%%....%..%%..%....%%%...%%.......%.%.%%%%.%%....%%....%%%...%%...
m .......%%...............%%%...............%%.....%%................%%.....%%...............%%%...............%%...
m .%%...%%%...............%%................%%.....%..................%.....%%................%%...............%%%..
m .%%....%%................%..........1.....%%.....%..................%.....%%.....0..........%................%%...
m .%%...%%%.%..%....%.....%%.............%%.%%%...%%%...%%......%%...%%%...%%%.%%.............%%.....%....%..%.%%%..
m .......%%%%%%%%%%%%%%%%%%%%...%%%%%%%%%%%%%%.....%.....%%....%%.....%.....%%%%%%%%%%%%%%...%%%%%%%%%%%%%%%%%%%%...
m .%%...%%%%%.%%%%%%.%..%..%....%.%...%%...%.%....%....................%....%.%...%%...%.%....%..%..%.%%%%%%.%%%%%..
m .......%......................................................................................................%...
m .%%...%%%....................................................................................................%%%..
m .......%......................................................................................................%...
m .%%....%%....%.%....%%..%%%.%%%.%...%%%.%.%..%%..%%....%......%....%%..%%..%.%.%%%...%.%%%.%%%..%%....%.%....%%...
m ......%%%...%%%%%%%%%%%%%%%%%%%%%%%%%%%%%%%%%%%%%%%....%%....%%....%%%%%%%%%%%%%%%%%%%%%%%%%%%%%%%%%%%%%%%...%%%..
m .%%.....%....%%....%%%..%%%.%.%%....%%%.%...%.....%...%%......%%...%.....%...%.%%%....%%.%.%%%..%%%....%%....%....
m .............%%..........%...........%..........................................%...........%..........%%.........
m .............%%.........%%%..........%%........................................%%..........%%%.........%%.........
m ............%%%..........%%.........%%%........................................%%%.........%%..........%%%........
m ......%.%...%%%......%%%%%....%%....%%....%%%.........%.%....%.%.........%%%....%%....%%....%%%%%......%%%...%.%..
m %%%%%%%%%%%%%%%.0.%%%%%%%%.....%%....%%....%%%%%%%.....%......%.....%%%%%%%....%%....%%.....%%%%%%%%.1.%%%%%%%%%%%
m ......%%...%%%%...%.%%%.%%%...%%....%%%....%%%..%.....%%%....%%%.....%..%%%....%%%....%%...%%%.%%%.%...%%%%...%%..
m ............%%%.........%%....%%...........%%............................%%...........%%....%%.........%%%........
m ............%%%..........%%....%..........%%%............................%%%..........%....%%..........%%%........
m ............%%%..........%....%%%.........%%..............................%%.........%%%....%..........%%%........
m ............%%%..........%....%%%%.%.%%%..%%....%%%....%%....%%....%%%....%%..%%%.%.%%%%....%..........%%%........
m .......%%%%%%%.....%....%%%....%%%%%%%%%%%%%.....%%%%%%%......%%%%%%%.....%%%%%%%%%%%%%....%%%....%.....%%%%%%%...
m .%%....%%.%..%.....%%...%%..........%%..%%%.%...%%%%%%%%......%%%%%%%%...%.%%%..%%..........%%...%%.....%..%.%%...
m .......%%...............%%......................%%...1.%%....%%.0...%%......................%%...............%%...
m ......%%%...............%%......................%%%....%%....%%....%%%......................%%...............%%%..
m ......%%%................%.......................%%...%%%....%%%...%%.......................%................%%%..
m .%%...%%....%......%.....%%%%.%%%....%%....%%..%%%%...%%......%%...%%%%..%%....%%....%%%.%%%%.....%......%....%%..
m .......%%....%%%%%%%%...%%%%%%%%%...%%.....%%%%%%%.....%%....%%.....%%%%%%%.....%%...%%%%%%%%%...%%%%%%%%....%%...
m ......%%%...%%%..%..%...%%..%.%%%....%......%%%...%....%......%....%...%%%......%....%%%.%..%%...%..%..%%%...%%%..
m .%%..........%.................%....%%%................%%....%%................%%%....%.................%.........
m .............%................%%....%%%...............%%%....%%%...............%%%....%%................%.........
m .%%.........%%................%%%.0.%%.................%%....%%.................%%.1.%%%................%%........
m ......%%.%%.%%......%..%%.....%%%....%%..%..%%%%%%%%%.%%......%%.%%%%%%%%%..%..%%....%%%.....%%..%......%%.%%.%%..
m ......%%%%%%%%.....%%%%%%%....%%.....%%%%%%%%%%%%%%%%%%%%....%%%%%%%%%%%%%%%%%%%%.....%%....%%%%%%%.....%%%%%%%%..
m ......%....%%%%....%.%..%%....%%%...%%%.%%%...%.%%%.%.%%......%%.%.%%%.%...%%%.%%%...%%%....%%..%.%....%%%%....%..
m .%%..........%%.........%%.....%......................................................%.....%%.........%%.........
m ............%%%.........%%.....%......................................................%.....%%.........%%%........
m .%%.........%%..........%%%...%%......................................................%%...%%%..........%%........
m %%%%%.%.%...%%%.%%%%....%%%..%%%%%%%..%%%.%.%..%%%.....%......%.....%%%..%.%.%%%..%%%%%%%..%%%....%%%%.%%%...%.%.%
m %%%%%%%%.....%%%%%%%%....%%%%%%%%%%%%%%%%%%%%%%%%%%...%%%%%%%%%%...%%%%%%%%%%%%%%%%%%%%%%%%%%....%%%%%%%%.....%%%%
m .%%.%%%%.....%%...%%......%.%%..%%.%.%....%%%%...%....%.%....%.%....%...%%%%....%.%.%%..%%.%......%%...%%.....%%%%
m .%%....%%..........%..............................................................................%..........%%...
m .%%....%%.........%%%............................................................................%%%.........%%...
m ......%%...........%%............................................................................%%...........%%..
m ......%%%..%%.%...%%%%.%.%.%%..%..%%%.%....%%.%.%.......%....%.......%.%.%%....%.%%%..%..%%.%.%.%%%%...%.%%..%%%..
m .%%...%%%%%%%%%...%%%%%%%%%%%%%%%%%%%%....%%%%%%%%%....%......%....%%%%%%%%%....%%%%%%%%%%%%%%%%%%%%...%%%%%%%%%..
m .%%...%..%..%%%....%..%.%%%%%%..%%.%%%%.....%...%%%....%......%....%%%...%.....%%%%.%%..%%%%%%.%..%....%%%..%..%..
m .%%.....................%%..........%%..........%%%...%%......%%...%%%..........%%..........%%....................
m .........................%%.........%%...........%%...%%......%%...%%...........%%.........%%.....................
m .%%......................%%..........%...........%%...%%%....%%%...%%...........%..........%%.....................
m .......%.%%..%...%%%.%%.%%%....%%....%%%%.%%.....%%....%......%....%%.....%%.%%%%....%%....%%%.%%.%%%...%..%%.%...
m .%%....%%%%%%%%%%%%%%%%%%%%...%%....%%%%%%%%....%%.....%%....%%.....%%....%%%%%%%%....%%...%%%%%%%%%%%%%%%%%%%%...
m .......%%..%.%...%.%.%...%.....%.......%..%%....%.....%%......%%.....%....%%..%.......%.....%...%.%.%...%.%..%%...
m .%%...%%.......................%...........%%.........%%......%%.........%%...........%.......................%%..
m .%%....%%......................%..........%%..........%%......%%..........%%..........%......................%%...
m ......%%%......................%..........%%%..........%......%..........%%%..........%......................%%%..
m %%%%%%%%%....%%.%......%%%%...%%%%.%%.%....%....%%%%%%%%%....%%%%%%%%%....%....%.%%.%%%%...%%%%......%.%%....%%%%%
m %%%%%%%%.....%%%%%%%%%%%%%%%%%%%%%%%%%%....%%...%%%%%%%%%....%%%%%%%%%...%%....%%%%%%%%%%%%%%%%%%%%%%%%%%.....%%%%
m %%%%..%.....%%%.%%%.%%.%.%..%.%%%%%.%%.....%....%%%%%%.%......%.%%%%%%....%.....%%.%%%%%.%..%.%.%%.%%%.%%%.....%..
m .%%..........%%.....................%%.....%....%%..................%%....%.....%%.....................%%.........
m .............%%.....................%%....%%....%%%................%%%....%%....%%.....................%%.........
m ............%%.......................%%....%%...%%..................%%...%%....%%.......................%%........
m .%%...%..%%%%%%....%...%.%.....%%...%%.....%%%.%%%%...%.%.%%.%.%...%%%%.%%%.....%%...%%.....%.%...%....%%%%%%..%..
m .......%%%%%%%.....%%%%%%%%%%%%%.....%%....%%%%%%%%...%%%%%%%%%%...%%%%%%%%....%%.....%%%%%%%%%%%%%.....%%%%%%%...
m ......%%%.%.%%%....%%.%.%%%%%%%%.....%.....%%%.%%%.....%%%%%%%%.....%%%.%%%.....%.....%%%%%%%%.%.%%....%%%.%.%%%..
m ......%%%.........%%%...%%%.........%%..........%%..................%%..........%%.........%%%...%%%.........%%%..
m ......%%...........%....%%...........%%.........%%..................%%.........%%...........%%....%...........%%..
m .......%..........%%%...%%%.........%%%.........%%%................%%%.........%%%.........%%%...%%%..........%...
m .......%......%%%.%%%....%%...%%..%%%%%...%.%....%%....%%....%%....%%....%.%...%%%%%..%%...%%....%%%.%%%......%...
m .%%....%%....%%%%%%%.....%%....%%%%%%%%%%%%%%....%.....%%....%%.....%....%%%%%%%%%%%%%%....%%.....%%%%%%%....%%...
m ......%.%...%%%...%%%....%....%%%.%%.%.%%%%%....%%%....%%....%%....%%%....%%%%%.%.%%.%%%....%....%%%...%%%...%.%..
m .%%.........%%..........%%....%%%.........%%%...%%%...%%%....%%%...%%%...%%%.........%%%....%%..........%%........
m .%%.........%%..........%%%....%...........%....%%....%%%....%%%....%%....%...........%....%%%..........%%........
m .............%..........%%....%%..........%%....%%....%%%....%%%....%%....%%..........%%....%%..........%.........
m .........%..%%%.%.%.%....%....%%%....%%....%%....%%..%%%......%%%..%%....%%....%%....%%%....%....%.%.%.%%%..%.....
m ......%%%%%%%%%%%%%%.....%%...%%%...%%%....%.....%%%%%%%......%%%%%%%.....%....%%%...%%%...%%.....%%%%%%%%%%%%%%..
m .......%%%%%%%%%%%%%%....%....%%%...%%.....%.......%.%..%....%..%.%.......%.....%%...%%%....%....%%%%%%%%%%%%%%...
m .%%......................%%..........%%...%%%............................%%%...%%..........%%.....................
m ........................%%%..........%....%%%............................%%%....%..........%%%....................
m ........................%%...........%%....%%............................%%....%%...........%%....................
m ......%.%%..%...%....%%.%%%..%.%%%%%%%%....%%.%%.%..%%%%%%%%%%%%%%..%.%%.%%....%%%%%%%%.%..%%%.%%....%...%..%%.%..
m .%%...%%%%%%%%%%%%%%%%%%%%%%%%%%%%%%%%%...%%%%%%%%%%%%%%%%%%%%%%%%%%%%%%%%%%...%%%%%%%%%%%%%%%%%%%%%%%%%%%%%%%%%..
m .%%....%%.%...%%%..%%..%%%%.......%%.%%...%%%%..%.%..%..........%..%.%..%%%%...%%.%%.......%%%%..%%..%%%...%.%%...
m .......%%................%................%%..............................%%................%................%%...